year,month_no,month_name,sales,expenditure,profit
2018,1,January,6226,3808,2418
2018,2,February,1521,3373,-1852
2018,3,March,1842,3965,-2123
2018,4,April,2051,1098,953
2018,5,May,1728,3046,-1318
2018,6,June,2138,2258,-120
2018,7,July,7479,2084,5395
2018,8,August,4434,2799,1635
2018,9,September,3615,1649,1966
2018,10,October,5472,1116,4356
2018,11,November,7224,1431,5793
2018,12,December,1812,3532,-1720
